#######################
#........#............#
#........#............#
#........###..........#
#.....................#
#........###..........#
#........#............#
#........#............#
#........#............#
#........#............#
#######################
